XXXXXXXX1111111111111111111111111
XXXXXXXX1000000000110000000000001
XXXXXXXX1011000001110000000000001
XXXXXXXX1001000000000000000000001
111111111011000001110000000000001
100000000000000001110111111111111
11110111101111011100000010001XXXX
11110111111111011101010010001XXXX
11000000110101011100000010001XXXX
10000000000000001100000010001XXXX
10000000000000000000010000001XXXX
11000001110101011111011110E111XX1
11110111X1110101X101111010001XXXX
11111111X1111111X111111111111XXXX
XXXXXXXX1111111111111111111111111
