11111111111111111111111111111
11111100000000000000000000011
111111111100001110000000W0001
10000001100000000000010000001
11111111111111111111111111111
11111111111111111111111111111
