1111111111
1000001101
1110000001
1111110111
1110000001
1110000001
1110000001
111000S001
1110000001
1111111111
